55454770000007343031
03131611100101613130
03243270010007234230
30423511100001532403
56030470000117403065
44075430001113457044
34743441110004434743
34563450010105436543
12343430100113434321
63755221101002255736
22321131100013112322