00034350000030054766
05430540604065465460
20405361116136754011
04030134604000434534
60010456043175043206
04300717747063130604
22205354610341643000
00430504030043066100
46004171734043040466
60203741045470504757
51504100000001175747
