02304054000044430534
02340105032050300010
30204130250302503051
40053041024050532032
30501035035030134445
00010405010010405454
10304030430403010500
00040445040042004304
04032040500450450430
45040504010300034044
32203000000050030030