41000000000000000014
10000000000000000001
00000000000000000000
00003311555511330000
20000531155113500002
42000053111135000024
20000005344350000002
00000005311350000000
00000000222200000000
10000000000000000001
41000000000000000014